"a" = (/turf/open/floor/rogue/cobble,/area/rogue/indoors/dungeonrand)
"d" = (/obj/machinery/light/rogue/campfire,/turf/open/floor/rogue/dirt,/area/rogue/outdoors/mountains/decap)
"i" = (/turf/open/floor/rogue/cobble,/area/rogue/outdoors/mountains/decap)
"n" = (/turf/open/floor/rogue/dirt/road,/area/rogue/outdoors/mountains/decap)
"t" = (/obj/item/chair/stool/bar/rogue,/turf/open/floor/rogue/dirt,/area/rogue/outdoors/mountains/decap)
"A" = (/obj/structure/chair/stool/rogue,/turf/open/floor/rogue/dirt,/area/rogue/outdoors/mountains/decap)
"C" = (/obj/structure/fluff/traveltile,/turf/open/floor/rogue/dirt,/area/rogue/outdoors/mountains/decap)
"D" = (/turf/open/floor/rogue/cobblerock,/area/rogue/indoors/dungeonrand)
"I" = (/obj/effect/landmark/map_load_mark/tensize,/turf/open/floor/rogue/cobblerock,/area/rogue/indoors/dungeonrand)
"N" = (/turf/closed/mineral/rogue/bedrock,/area/rogue/indoors/dungeonrand)
"O" = (/turf/closed/mineral/rogue/bedrock,/area/rogue/outdoors/mountains/decap)
"S" = (/turf/open/floor/rogue/dirt,/area/rogue/outdoors/mountains/decap)

(1,1,1) = {"
aaaaaaaaaaaaaaaaaaaaaaaaaaaaaaaaaaaaaaaaaaaaaaaaaaaaaaaaaaaaaaaaaaaaaaaaaaaaaaaaaaaaaaaaaaaaaaaaaaaaaaaaaaaaaaaaaaaaaaaaaaaaaaaaaa
aaaaaaaaaaaaaaaaaaaaaaaaaaaaaaaaaaaaaaaaaaaaaaaaaaaaaaaaaaaaaaaaaaaaaaaaaaaaaaaaaaaaaaaaaaaaaaaaaaaaaaaaaaaaaaaaaaaaaaaaaaaaaaaaaa
aaaaaaaaaaaaaaaaaaaaaaaaaaaaaaaaaaaaaaaaaaaaaaaaaaaaaaaaaaaaaaaaaaaaaaaaaaaaaaaaaaaaaaaaaaaaaaaaaaaaaaaaaaaaaaaaaaaaaaaaaaaaaaaaaa
aaaaaaaaaaaaaaaaaaaaaaaaaaaaaaaaaaaaaaaaaaaaaaaaaaaaaaaaaaaaaaaaaaaaaaaaaaaaaaaaaaaaaaaaaaaaaaaaaaaaaaaaaaaaaaaaaaaaaaaaaaaaaaaaaa
aaaaaaaaaaaaaaaaaaaaaaaaaaaaaaaaaaaaaaaaaaaaaaaaaaaaaaaaaaaaaaaaaaaaaaaaaaaaaaaaaaaaaaaaaaaaaaaaaaaaaaaaaaaaaaaaaaaaaaaaaaaaaaaaaa
aaaaaaaaaaaaaaaaaaaaaaaaaaaaaaaaaaaaaaaaaaaaaaaaaaaaaaaaaaaaaaaaaaaaaaaaaaaaaaaaaaaaaaaaaaaaaaaaaaaaaaaaaaaaaaaaaaaaaaaaaaaaaaaaaa
aaaaaaaaaaaaaaaaaaaaaaaaaaaaaaaaaaaaaaaaaaaaaaaaaaaaaaaaaaaaaaaaaaaaaaaaaaaaaaaaaaaaaaaaaaaaaaaaaaaaaaaaaaaaaaaaaaaaaaaaaaaaaaaaaa
aaaaaaaaaaaaaaaaaaaaaaaaaaaaaaaaaaaaaaaaaaaaaaaaaaaaaaaaaaaaaaaaaaaaaaaaaaaaaaaaaaaaaaaaaaaaaaaaaaaaaaaaaaaaaaaaaaaaaaaaaaaaaaaaaa
aaaaaaaaaaaaaaaaaaaaaaaaaaaaaaaaaaaaaaaaaaaaaaaaaaaaaaaaaaaaaaaaaaaaaaaaaaaaaaaaaaaaaaaaaaaaaaaaaaaaaaaaaaaaaaaaaaaaaaaaaaaaaaaaaa
aaaaaaaaaaaaaaaaaaaaaaaaaaaaaaaaaaaaaaaaaaaaaaaaaaaaaaaaaaaaaaaaaaaaaaaaaaaaaaaaaaaaaaaaaaaaaaaaaaaaaaaaaaaaaaaaaaaaaaaaaaaaaaaaaa
aaaaNDDDDNaaaaaaaaaaaaaNDDDDNaaaaaaaaaaaaaaaaaaaaaaaaaaaaaaaaaaaaaaaaaaaaaaaaaaaaaaaaaaaaaaaaaaaaaaaaaaaaaaaaaaaaaaaaaaaaaaaaaaaaa
aaaaNDDDDNaaaaaaaaaaaaaNDDDDNaaaaaaaaaaaaaaaaaaaaaaaaaaaaaaaaaaaaaaaaaaaaaaaaaaaaaaaaaaaaaaaaaaaaaaaaaaaaaaaaaaaaaaaaaaaaaaaaaaaaa
aaaaNDDDDNaaaaaaaaaaaaaNDDDDNaaaaaaaaaaaaaaaaaaaaaaaaaaaaaaaaaaaaaaaaaaaaaaaaaaaaaaaaaaaaaaaaaaaaaaaaaaaaaaaaaaaaaaaaaaaaaaaaaaaaa
aaaaNDDDDNaaaaaaaaaaaaaNDDDDNaaaaaaaaaaaaaaaaaaaaaaaaaaaaaaaaaaaaaaaaaaaaaaaaaaaaaaaaaaaaaaaaaaaaaaaaaaaaaaaaaaaaaaaaaaaaaaaaaaaaa
aaaaNDDDDNaaaaaaaaaaaaaNDDDDNaaaaaaaaaaaaaaaaaaaaaaaaaaaaaaaaaaaaaaaaaaaaaaaaaaaaaaaaaaaaaaaaaaaaaaaaaaaaaaaaaaaaaaaaaaaaaaaaaaaaa
aaaaNDDDDNaaaaaaaaaaaaaNDDDDNaaaaaaaaaaaaaaaaaaaaaaaaaaaaaaaaaaaaaaaaaaaaaaaaaaaaaaaaaaaaaaaaaaaaaaaaaaaaaaaaaaaaaaaaaaaaaaaaaaaaa
aaaaNDDDDNaaaaaaaaaaaaaNDDDDNaaaaaaaaaaaaaaaaaaaaaaaaaaaaaaaaaaaaaaaaaaaaaaaaaaaaaaaaaaaaaaaaaaaaaaaaaaaaaaaaaaaaaaaaaaaaaaaaaaaaa
aNNNNDDDDNNNNaaaaaaaNNNNDDDDNNNNaaaaaaaNNNNDDDDNNNNaaaaaaaNNNNDDDDNNNNaaaaaaaNNNNDDDDNNNNaaaaaaaNNNNDDDDNNNNaaaaaaaaaaaaaaaaaaaaaa
aNDDDDDDDDDDNaaaaaaaNDDDDDDDDDDNaaaaaaaNDDDDDDDDDDNaaaaaaaNDDDDDDDDDDNaaaaaaaNDDDDDDDDDDNaaaaaaaNDDDDDDDDDDNaaaaaaaaaaaaaaaaaaaaaa
aNDDDDDDDDDDNaaaaaaaNDDDDDDDDDDNaaaaaaaNDDDDDDDDDDNaaaaaaaNDDDDDDDDDDNaaaaaaaNDDDDDDDDDDNaaaaaaaNDDDDDDDDDDNaaaaaaaaaaaaaaaaaaaaaa
aNDDDDDDDDDDNNNNNNNNNDDDDDDDDDDNNNNNNNNNDDDDDDDDDDNNNNNNNNNDDDDDDDDDDNNNNNNNNNDDDDDDDDDDNNNNNNNNNDDDDDDDDDDNNNNNNNNaaaaaaaaaaaaaaa
aNDDDDDDDDDDDDDDDDDDDDDDDDDDDDDDDDDDDDDDDDDDDDDDDDDDDDDDDDDDDDDDDDDDDDDDDDDDDDDDDDDDDDDDDDDDDDDDDDDDDDDDDDDDDDDDDDDaaaaaaaaaaaaaaa
aNDDDDDDDDDDDDDDDDDDDDDDDDDDDDDDDDDDDDDDDDDDDDDDDDDDDDDDDDDDDDDDDDDDDDDDDDDDDDDDDDDDDDDDDDDDDDDDDDDDDDDDDDDDDDDDDDDaaaaaaaaaaaaaaa
aNDDDDDDDDDDDDDDDDDDDDDDDDDDDDDDDDDDDDDDDDDDDDDDDDDDDDDDDDDDDDDDDDDDDDDDDDDDDDDDDDDDDDDDDDDDDDDDDDDDDDDDDDDDDDDDDDDaaaaaaaaaaaaaaa
aNDDDDDDDDDDDDDDDDDDDDDDDDDDDDDDDDDDDDDDDDDDDDDDDDDDDDDDDDDDDDDDDDDDDDDDDDDDDDDDDDDDDDDDDDDDDDDDDDDDDDDDDDDDDDDDDDDaaaaaaaaaaaaaaa
aNDDDDDDDDDDNNNNNNNNNDDDDDDDDDDNNNNNNNNNDDDDDDDDDDNNNNNNNNNDDDDDDDDDDNNNNNNNNNDDDDDDDDDDNNNNNNNNNDDDDDDDDDDNNNNNNNNaaaaaaaaaaaaaaa
aNDDDDDDDDDDNaaaaaaaNDDDDDDDDDDNaaaaaaaNDDDDDDDDDDNaaaaaaaNDDDDDDDDDDNaaaaaaaNDDDDDDDDDDNaaaaaaaNDDDDDDDDDDNaaaaaaaaaaaaaaaaaaaaaa
aNIDDDDDDDDDNaaaaaaaNIDDDDDDDDDNaaaaaaaNIDDDDDDDDDNaaaaaaaNIDDDDDDDDDNaaaaaaaNIDDDDDDDDDNaaaaaaaNIDDDDDDDDDNaaaaaaaaaaaaaaaaaaaaaa
aNNNNDDDDNNNNaaaaaaaNNNNDDDDNNNNaaaaaaaNNNNDDDDNNNNaaaaaaaNNNNDDDDNNNNaaaaaaaNNNNDDDDNNNNaaaaaaaNNNNDDDDNNNNaaaaaaaaaaaaaaaaaaaaaa
aaaaNDDDDNaaaaaaaaaaaaaNDDDDNaaaaaaaaaaaaaNDDDDNaaaaaaaaaaaaaNDDDDNaaaaaaaaaaaaaNDDDDNaaaaaaaaaaaaaNDDDDNaaaaaaaaaaaaaaaaaaaaaaaaa
aaaaNDDDDNaaaaaaaaaaaaaNDDDDNaaaaaaaaaaaaaNDDDDNaaaaaaaaaaaaaNDDDDNaaaaaaaaaaaaaNDDDDNaaaaaaaaaaaaaNDDDDNaaaaaaaaaaaaaaaaaaaaaaaaa
aaaaNDDDDNaaaaaaaaaaaaaNDDDDNaaaaaaaaaaaaaNDDDDNaaaaaaaaaaaaaNDDDDNaaaaaaaaaaaaaNDDDDNaaaaaaaaaaaaaNDDDDNaaaaaaaaaaaaaaaaaaaaaaaaa
aaaaNDDDDNaaaaaaaaaaaaaNDDDDNaaaaaaaaaaaaaNDDDDNaaaaaaaaaaaaaNDDDDNaaaaaaaaaaaaaNDDDDNaaaaaaaaaaaaaNDDDDNaaaaaaaaaaaaaaaaaaaaaaaaa
aaaaNDDDDNaaaaaaaaaaaaaNDDDDNaaaaaaaaaaaaaNDDDDNaaaaaaaaaaaaaNDDDDNaaaaaaaaaaaaaNDDDDNaaaaaaaaaaaaaNDDDDNaaaaaaaaaaaaaaaaaaaaaaaaa
aaaaNDDDDNaaaaaaaaaaaaaNDDDDNaaaaaaaaaaaaaNDDDDNaaaaaaaaaaaaaNDDDDNaaaaaaaaaaaaaNDDDDNaaaaaaaaaaaaaNDDDDNaaaaaaaaaaaaaaaaaaaaaaaaa
aaaaNDDDDNaaaaaaaaaaaaaNDDDDNaaaaaaaaaaaaaNDDDDNaaaaaaaaaaaaaNDDDDNaaaaaaaaaaaaaNDDDDNaaaaaaaaaaaaaNDDDDNaaaaaaaaaaaaaaaaaaaaaaaaa
aNNNNDDDDNNNNaaaaaaaNNNNDDDDNNNNaaaaaaaNNNNDDDDNNNNaaaaaaaNNNNDDDDNNNNaaaaaaaNNNNDDDDNNNNaaaaaaaNNNNDDDDNNNNaaaaaaaNNNNDDDDNNNNaaa
aNDDDDDDDDDDNaaaaaaaNDDDDDDDDDDNaaaaaaaNDDDDDDDDDDNaaaaaaaNDDDDDDDDDDNaaaaaaaNDDDDDDDDDDNaaaaaaaNDDDDDDDDDDNaaaaaaaNDDDDDDDDDDNaaa
aNDDDDDDDDDDNaaaaaaaNDDDDDDDDDDNaaaaaaaNDDDDDDDDDDNaaaaaaaNDDDDDDDDDDNaaaaaaaNDDDDDDDDDDNaaaaaaaNDDDDDDDDDDNaaaaaaaNDDDDDDDDDDNaaa
aNDDDDDDDDDDNNNNNNNNNDDDDDDDDDDNNNNNNNNNDDDDDDDDDDNNNNNNNNNDDDDDDDDDDNNNNNNNNNDDDDDDDDDDNNNNNNNNNDDDDDDDDDDNNNNNNNNNDDDDDDDDDDNaaa
aNDDDDDDDDDDDDDDDDDDDDDDDDDDDDDDDDDDDDDDDDDDDDDDDDDDDDDDDDDDDDDDDDDDDDDDDDDDDDDDDDDDDDDDDDDDDDDDDDDDDDDDDDDDDDDDDDDDDDDDDDDDDDDaaa
aNDDDDDDDDDDDDDDDDDDDDDDDDDDDDDDDDDDDDDDDDDDDDDDDDDDDDDDDDDDDDDDDDDDDDDDDDDDDDDDDDDDDDDDDDDDDDDDDDDDDDDDDDDDDDDDDDDDDDDDDDDDDDDaaa
aNDDDDDDDDDDDDDDDDDDDDDDDDDDDDDDDDDDDDDDDDDDDDDDDDDDDDDDDDDDDDDDDDDDDDDDDDDDDDDDDDDDDDDDDDDDDDDDDDDDDDDDDDDDDDDDDDDDDDDDDDDDDDDaaa
aNDDDDDDDDDDDDDDDDDDDDDDDDDDDDDDDDDDDDDDDDDDDDDDDDDDDDDDDDDDDDDDDDDDDDDDDDDDDDDDDDDDDDDDDDDDDDDDDDDDDDDDDDDDDDDDDDDDDDDDDDDDDDDaaa
aNDDDDDDDDDDNNNNNNNNNDDDDDDDDDDNNNNNNNNNDDDDDDDDDDNNNNNNNNNDDDDDDDDDDNNNNNNNNNDDDDDDDDDDNNNNNNNNNDDDDDDDDDDNNNNNNNNNDDDDDDDDDDNaaa
aNDDDDDDDDDDNaaaaaaaNDDDDDDDDDDNaaaaaaaNDDDDDDDDDDNaaaaaaaNDDDDDDDDDDNaaaaaaaNDDDDDDDDDDNaaaaaaaNDDDDDDDDDDNaaaaaaaNDDDDDDDDDDNaaa
aNIDDDDDDDDDNaaaaaaaNIDDDDDDDDDNaaaaaaaNIDDDDDDDDDNaaaaaaaNIDDDDDDDDDNaaaaaaaNIDDDDDDDDDNaaaaaaaNIDDDDDDDDDNaaaaaaaNIDDDDDDDDDNaaa
aNNNNDDDDNNNNaaaaaaaNNNNDDDDNNNNaaaaaaaNNNNDDDDNNNNaaaaaaaNNNNDDDDNNNNaaaaaaaNNNNDDDDNNNNaaaaaaaNNNNDDDDNNNNaaaaaaaNNNNDDDDNNNNaaa
aaaaNDDDDNaaaaaaaaaaaaaNDDDDNaaaaaaaaaaaaaNDDDDNaaaaaaaaaaaaaNDDDDNaaaaaaaaaaaaaNDDDDNaaaaaaaaaaaaaNDDDDNaaaaaaaaaaaaaNDDDDNaaaaaa
aaaaNDDDDNaaaaaaaaaaaaaNDDDDNaaaaaaaaaaaaaNDDDDNaaaaaaaaaaaaaNDDDDNaaaaaaaaaaaaaNDDDDNaaaaaaaaaaaaaNDDDDNaaaaaaaaaaaaaNDDDDNaaaaaa
aaaaNDDDDNaaaaaaaaaaaaaNDDDDNaaaaaaaaaaaaaNDDDDNaaaaaaaaaaaaaNDDDDNaaaaaaaaaaaaaNDDDDNaaaaaaaaaaaaaNDDDDNaaaaaaaaaaaaaNDDDDNaaaaaa
aaaaNDDDDNaaaaaaaaaaaaaNDDDDNaaaaaaaaaaaaaNDDDDNaaaaaaaaaaaaaNDDDDNaaaaaaaaaaaaaNDDDDNaaaaaaaaaaaaaNDDDDNaaaaaaaaaaaaaNDDDDNaaaaaa
aaaaNDDDDNaaaaaaaaaaaaaNDDDDNaaaaaaaaaaaaaNDDDDNaaaaaaaaaaaaaNDDDDNaaaaaaaaaaaaaNDDDDNaaaaaaaaaaaaaNDDDDNaaaaaaaaaaaaaNDDDDNaaaaaa
aaaaNDDDDNaaaaaaaaaaaaaNDDDDNaaaaaaaaaaaaaNDDDDNaaaaaaaaaaaaaNDDDDNaaaaaaaaaaaaaNDDDDNaaaaaaaaaaaaaNDDDDNaaaaaaaaaaaaaNDDDDNaaaaaa
aaaaNDDDDNaaaaaaaaaaaaaNDDDDNaaaaaaaaaaaaaNDDDDNaaaaaaaaaaaaaNDDDDNaaaaaaaaaaaaaNDDDDNaaaaaaaaaaaaaNDDDDNaaaaaaaaaaaaaNDDDDNaaaaaa
aNNNNDDDDNNNNaaaaaaaNNNNDDDDNNNNaaaaaaaNNNNDDDDNNNNaaaaaaaNNNNDDDDNNNNaaaaaaaNNNNDDDDNNNNaaaaaaaNNNNDDDDNNNNaaaaaaaNNNNDDDDNNNNaaa
aNDDDDDDDDDDNaaaaaaaNDDDDDDDDDDNaaaaaaaNDDDDDDDDDDNaaaaaaaNDDDDDDDDDDNaaaaaaaNDDDDDDDDDDNaaaaaaaNDDDDDDDDDDNaaaaaaaNDDDDDDDDDDNaaa
aNDDDDDDDDDDNaaaaaaaNDDDDDDDDDDNaaaaaaaNDDDDDDDDDDNaaaaaaaNDDDDDDDDDDNaaaaaaaNDDDDDDDDDDNaaaaaaaNDDDDDDDDDDNaaaaaaaNDDDDDDDDDDNaaa
aNDDDDDDDDDDNNNNNNNNNDDDDDDDDDDNNNNNNNNNDDDDDDDDDDNNNNNNNNNDDDDDDDDDDNNNNNNNNNDDDDDDDDDDNNNNNNNNNDDDDDDDDDDNNNNNNNNNDDDDDDDDDDNaaa
aNDDDDDDDDDDDDDDDDDDDDDDDDDDDDDDDDDDDDDDDDDDDDDDDDDDDDDDDDDDDDDDDDDDDDDDDDDDDDDDDDDDDDDDDDDDDDDDDDDDDDDDDDDDDDDDDDDDDDDDDDDDDDDaaa
aNDDDDDDDDDDDDDDDDDDDDDDDDDDDDDDDDDDDDDDDDDDDDDDDDDDDDDDDDDDDDDDDDDDDDDDDDDDDDDDDDDDDDDDDDDDDDDDDDDDDDDDDDDDDDDDDDDDDDDDDDDDDDDaaa
aNDDDDDDDDDDDDDDDDDDDDDDDDDDDDDDDDDDDDDDDDDDDDDDDDDDDDDDDDDDDDDDDDDDDDDDDDDDDDDDDDDDDDDDDDDDDDDDDDDDDDDDDDDDDDDDDDDDDDDDDDDDDDDaaa
aNDDDDDDDDDDDDDDDDDDDDDDDDDDDDDDDDDDDDDDDDDDDDDDDDDDDDDDDDDDDDDDDDDDDDDDDDDDDDDDDDDDDDDDDDDDDDDDDDDDDDDDDDDDDDDDDDDDDDDDDDDDDDDaaa
aNDDDDDDDDDDNNNNNNNNNDDDDDDDDDDNNNNNNNNNDDDDDDDDDDNNNNNNNNNDDDDDDDDDDNNNNNNNNNDDDDDDDDDDNNNNNNNNNDDDDDDDDDDNNNNNNNNNDDDDDDDDDDNaaa
aNDDDDDDDDDDNaaaaaaaNDDDDDDDDDDNaaaaaaaNDDDDDDDDDDNaaaaaaaNDDDDDDDDDDNaaaaaaaNDDDDDDDDDDNaaaaaaaNDDDDDDDDDDNaaaaaaaNDDDDDDDDDDNaaa
aNIDDDDDDDDDNaaaaaaaNIDDDDDDDDDNaaaaaaaNIDDDDDDDDDNaaaaaaaNIDDDDDDDDDNaaaaaaaNIDDDDDDDDDNaaaaaaaNIDDDDDDDDDNaaaaaaaNIDDDDDDDDDNaaa
aNNNNDDDDNNNNaaaaaaaNNNNDDDDNNNNaaaaaaaNNNNDDDDNNNNaaaaaaaNNNNDDDDNNNNaaaaaaaNNNNDDDDNNNNaaaaaaaNNNNDDDDNNNNaaaaaaaNNNNDDDDNNNNaaa
aaaaNDDDDNaaaaaaaaaaaaaNDDDDNaaaaaaaaaaaaaNDDDDNaaaaaaaaaaaaaNDDDDNaaaaaaaaaaaaaNDDDDNaaaaaaaaaaaaaNDDDDNaaaaaaaaaaaaaNDDDDNaaaaaa
aaaaNDDDDNaaaaaaaaaaaaaNDDDDNaaaaaaaaaaaaaNDDDDNaaaaaaaaaaaaaNDDDDNaaaaaaaaaaaaaNDDDDNaaaaaaaaaaaaaNDDDDNaaaaaaaaaaaaaNDDDDNaaaaaa
aaaaNDDDDNaaaaaaaaaaaaaNDDDDNaaaaaaaaaaaaaNDDDDNaaaaaaaaaaaaaNDDDDNaaaaaaaaaaaaaNDDDDNaaaaaaaaaaaaaNDDDDNaaaaaaaaaaaaaNDDDDNaaaaaa
aaaaNDDDDNaaaaaaaaaaaaaNDDDDNaaaaaaaaaaaaaNDDDDNaaaaaaaaaaaaaNDDDDNaaaaaaaaaaaaaNDDDDNaaaaaaaaaaaaaNDDDDNaaaaaaaaaaaaaNDDDDNaaaaaa
aaaaNDDDDNaaaaaaaaaaaaaNDDDDNaaaaaaaaaaaaaNDDDDNaaaaaaaaaaaaaNDDDDNaaaaaaaaaaaaaNDDDDNaaaaaaaaaaaaaNDDDDNaaaaaaaaaaaaaNDDDDNaaaaaa
aaaaNDDDDNaaaaaaaaaaaaaNDDDDNaaaaaaaaaaaaaNDDDDNaaaaaaaaaaaaaNDDDDNaaaaaaaaaaaaaNDDDDNaaaaaaaaaaaaaNDDDDNaaaaaaaaaaaaaNDDDDNaaaaaa
aaaaNDDDDNaaaaaaaaaaaaaNDDDDNaaaaaaaaaaaaaNDDDDNaaaaaaaaaaaaaNDDDDNaaaaaaaaaaaaaNDDDDNaaaaaaaaaaaaaNDDDDNaaaaaaaaaaaaaNDDDDNaaaaaa
aNNNNDDDDNNNNaaaaaaaNNNNDDDDNNNNaaaaaaaNNNNDDDDNNNNaaaaaaaNNNNDDDDNNNNaaaaaaaNNNNDDDDNNNNaaaaaaaNNNNDDDDNNNNaaaaaaaNNNNDDDDNNNNaaa
aNDDDDDDDDDDNaaaaaaaNDDDDDDDDDDNaaaaaaaNDDDDDDDDDDNaaaaaaaNDDDDDDDDDDNaaaaaaaNDDDDDDDDDDNaaaaaaaNDDDDDDDDDDNaaaaaaaNDDDDDDDDDDNaaa
aNDDDDDDDDDDNaaaaaaaNDDDDDDDDDDNaaaaaaaNDDDDDDDDDDNaaaaaaaNDDDDDDDDDDNaaaaaaaNDDDDDDDDDDNaaaaaaaNDDDDDDDDDDNaaaaaaaNDDDDDDDDDDNaaa
aNDDDDDDDDDDNNNNNNNNNDDDDDDDDDDNNNNNNNNNDDDDDDDDDDNNNNNNNNNDDDDDDDDDDNNNNNNNNNDDDDDDDDDDNNNNNNNNNDDDDDDDDDDNNNNNNNNNDDDDDDDDDDNaaa
aNDDDDDDDDDDDDDDDDDDDDDDDDDDDDDDDDDDDDDDDDDDDDDDDDDDDDDDDDDDDDDDDDDDDDDDDDDDDDDDDDDDDDDDDDDDDDDDDDDDDDDDDDDDDDDDDDDDDDDDDDDDDDDaaa
aNDDDDDDDDDDDDDDDDDDDDDDDDDDDDDDDDDDDDDDDDDDDDDDDDDDDDDDDDDDDDDDDDDDDDDDDDDDDDDDDDDDDDDDDDDDDDDDDDDDDDDDDDDDDDDDDDDDDDDDDDDDDDDaaa
aNDDDDDDDDDDDDDDDDDDDDDDDDDDDDDDDDDDDDDDDDDDDDDDDDDDDDDDDDDDDDDDDDDDDDDDDDDDDDDDDDDDDDDDDDDDDDDDDDDDDDDDDDDDDDDDDDDDDDDDDDDDDDDaaa
aNDDDDDDDDDDDDDDDDDDDDDDDDDDDDDDDDDDDDDDDDDDDDDDDDDDDDDDDDDDDDDDDDDDDDDDDDDDDDDDDDDDDDDDDDDDDDDDDDDDDDDDDDDDDDDDDDDDDDDDDDDDDDDaaa
aNDDDDDDDDDDNNNNNNNNNDDDDDDDDDDNNNNNNNNNDDDDDDDDDDNNNNNNNNNDDDDDDDDDDNNNNNNNNNDDDDDDDDDDNNNNNNNNNDDDDDDDDDDNNNNNNNNNDDDDDDDDDDNaaa
aNDDDDDDDDDDNaaaaaaaNDDDDDDDDDDNaaaaaaaNDDDDDDDDDDNaaaaaaaNDDDDDDDDDDNaaaaaaaNDDDDDDDDDDNaaaaaaaNDDDDDDDDDDNaaaaaaaNDDDDDDDDDDNaaa
aNIDDDDDDDDDNaaaaaaaNIDDDDDDDDDNaaaaaaaNIDDDDDDDDDNaaaaaaaNIDDDDDDDDDNaaaaaaaNIDDDDDDDDDNaaaaaaaNIDDDDDDDDDNaaaaaaaNIDDDDDDDDDNaaa
aNNNNDDDDNNNNaaaaaaaNNNNDDDDNNNNaaaaaaaNNNNDDDDNNNNaaaaaaaNNNNDDDDNNNNaaaaaaaNNNNDDDDNNNNaaaaaaaNNNNDDDDNNNNaaaaaaaNNNNDDDDNNNNaaa
aaaaNDDDDNaaaaaaaaaaaaaNDDDDNaaaaaaaaaaaaaNDDDDNaaaaaaaaaaaaaNDDDDNaaaaaaaaaaaaaNDDDDNaaaaaaaaaaaaaNDDDDNaaaaaaaaaaaaaNDDDDNaaaaaa
aaaaNDDDDNaaaaaaaaaaaaaNDDDDNaaaaaaaaaaaaaNDDDDNaaaaaaaaaaaaaNDDDDNaaaaaaaaaaaaaNDDDDNaaaaaaaaaaaaaNDDDDNaaaaaaaaaaaaaNDDDDNaaaaaa
aaaaNDDDDNaaaaaaaaaaaaaNDDDDNaaaaaaaaaaaaaNDDDDNaaaaaaaaaaaaaNDDDDNaaaaaaaaaaaaaNDDDDNaaaaaaaaaaaaaNDDDDNaaaaaaaaaaaaaNDDDDNaaaaaa
aaaaNDDDDNaaaaaaaaaaaaaNDDDDNaaaaaaaaaaaaaNDDDDNaaaaaaaaaaaaaNDDDDNaaaaaaaaaaaaaNDDDDNaaaaaaaaaaaaaNDDDDNaaaaaaaaaaaaaNDDDDNaaaaaa
aaaaNDDDDNaaaaaaaaaaaaaNDDDDNaaaaaaaaaaaaaNDDDDNaaaaaaaaaaaaaNDDDDNaaaaaaaaaaaaaNDDDDNaaaaaaaaaaaaaNDDDDNaaaaaaaaaaaaaNDDDDNaaaaaa
aaaaNDDDDNaaaaaaaaaaaaaNDDDDNaaaaaaaaaaaaaNDDDDNaaaaaaaaaaaaaNDDDDNaaaaaaaaaaaaaNDDDDNaaaaaaaaaaaaaNDDDDNaaaaaaaaaaaaaNDDDDNaaaaaa
aaaaNDDDDNaaaaaaaaaaaaaNDDDDNaaaaaaaaaaaaaNDDDDNaaaaaaaaaaaaaNDDDDNaaaaaaaaaaaaaNDDDDNaaaaaaaaaaaaaNDDDDNaaaaaaaaaaaaaNDDDDNaaaaaa
aNNNNDDDDNNNNaaaaaaaNNNNDDDDNNNNaaaaaaaNNNNDDDDNNNNaaaaaaaNNNNDDDDNNNNaaaaaaaNNNNDDDDNNNNaaaaaaaNNNNDDDDNNNNaaaaaaaNNNNDDDDNNNNaaa
aNDDDDDDDDDDNaaaaaaaNDDDDDDDDDDNaaaaaaaNDDDDDDDDDDNaaaaaaaNDDDDDDDDDDNaaaaaaaNDDDDDDDDDDNaaaaaaaNDDDDDDDDDDNaaaaaaaNDDDDDDDDDDNaaa
aNDDDDDDDDDDNaaaaaaaNDDDDDDDDDDNaaaaaaaNDDDDDDDDDDNaaaaaaaNDDDDDDDDDDNaaaaaaaNDDDDDDDDDDNaaaaaaaNDDDDDDDDDDNaaaaaaaNDDDDDDDDDDNaaa
aNDDDDDDDDDDNNNNNNNNNDDDDDDDDDDNNNNNNNNNDDDDDDDDDDNNNNNNNNNDDDDDDDDDDNNNNNNNNNDDDDDDDDDDNNNNNNNNNDDDDDDDDDDNNNNNNNNNDDDDDDDDDDNaaa
aNDDDDDDDDDDDDDDDDDDDDDDDDDDDDDDDDDDDDDDDDDDDDDDDDDDDDDDDDDDDDDDDDDDDDDDDDDDDDDDDDDDDDDDDDDDDDDDDDDDDDDDDDDDDDDDDDDDDDDDDDDDDDDaaa
aNDDDDDDDDDDDDDDDDDDDDDDDDDDDDDDDDDDDDDDDDDDDDDDDDDDDDDDDDDDDDDDDDDDDDDDDDDDDDDDDDDDDDDDDDDDDDDDDDDDDDDDDDDDDDDDDDDDDDDDDDDDDDDaaa
aNDDDDDDDDDDDDDDDDDDDDDDDDDDDDDDDDDDDDDDDDDDDDDDDDDDDDDDDDDDDDDDDDDDDDDDDDDDDDDDDDDDDDDDDDDDDDDDDDDDDDDDDDDDDDDDDDDDDDDDDDDDDDDaaa
aNDDDDDDDDDDDDDDDDDDDDDDDDDDDDDDDDDDDDDDDDDDDDDDDDDDDDDDDDDDDDDDDDDDDDDDDDDDDDDDDDDDDDDDDDDDDDDDDDDDDDDDDDDDDDDDDDDDDDDDDDDDDDDaaa
aNDDDDDDDDDDNNNNNNNNNDDDDDDDDDDNNNNNNNNNDDDDDDDDDDNNNNNNNNNDDDDDDDDDDNNNNNNNNNDDDDDDDDDDNNNNNNNNNDDDDDDDDDDNNNNNNNNNDDDDDDDDDDNaaa
aNDDDDDDDDDDNaaaaaaaNDDDDDDDDDDNaaaaaaaNDDDDDDDDDDNaaaaaaaNDDDDDDDDDDNaaaaaaaNDDDDDDDDDDNaaaaaaaNDDDDDDDDDDNaaaaaaaNDDDDDDDDDDNaaa
aNIDDDDDDDDDNaaaaaaaNIDDDDDDDDDNaaaaaaaNIDDDDDDDDDNaaaaaaaNIDDDDDDDDDNaaaaaaaNIDDDDDDDDDNaaaaaaaNIDDDDDDDDDNaaaaaaaNIDDDDDDDDDNaaa
aNNNNDDDDNNNNaaaaaaaNNNNDDDDNNNNaaaaaaaNNNNDDDDNNNNaaaaaaaNNNNDDDDNNNNaaaaaaaNNNNDDDDNNNNaaaaaaaNNNNDDDDNNNNaaaaaaaNNNNDDDDNNNNaaa
aaaaNDDDDNaaaaaaaaaaaaaaaaaaaaaaaaaaaaaaaaaaaaaaaaaaaaaaaaaaaaaaaaaaaaaaaaaaaaaaaaaaaaaaaaaaaaaaaaaaaaaaaaaaaaaaaaaaaaaaaaaaaaaaaa
aaaaNDDDDNaaaaaaaaaaaaaaaaaaaaaaaaaaaaaaaaaaaaaaaaaaaaaaaaaaaaaaaaaaaaaaaaaaaaaaaaaaaaaaaaaaaaaaaaaaaaaaaaaaaaaaaaaaaaaaaaaaaaaaaa
aaaaNDDDDNaaaaaaaaaaaaaaaaaaaaaaaaaaaaaaaaaaaaaaaaaaaaaaaaaaaaaaaaaaaaaaaaaaaaaaaaaaaaaaaaaaaaaaaaaaaaaaaaaaaaaaaaaaaaaaaaaaaaaaaa
aaaaNDDDDNaaaaaaaaaaaaaaaaaaaaaaaaaaaaaaaaaaaaaaaaaaaaaaaaaaaaaaaaaaaaaaaaaaaaaaaaaaaaaaaaaaaaaaaaaaaaaaaaaaaaaaaaaaaaaaaaaaaaaaaa
NaaaNDDDDNaaaaaaaaaaaaaaaaaaaaaaaaaaaaaaaaaaaaaaaaaaaaaaaaaaaaaaaaaaaaaaaaaaaaaaaaaaaaaaaaaaaaaaaaaaaaaaaaaaaaaaaaaaaaaaaaaaaaaaaa
NNaaNDDDDNaaaaaaaaaaaaaaaaaaaaaaaaaaaaaaaaaaaaaaaaaaaaaaaaaaaaaaaaaaaaaaaaaaaaaaaaaaaaaaaaaaaaaaaaaaaaaaaaaaaaaaaaaaaaaaaaaaaaaaaa
NNaaNDDDDNaaaaaaaaaaaaaaaaaaaaaaaaaaaaaaaaaaaaaaaaaaaaaaaaaaaaaaaaaaaaaaaaaaaaaaaaaaaaaaaaaaaaaaaaaaaaaaaaaaaaaaaaaaaaaaaaaaaaaaaa
NNaaNDDDDNaaaaaaaaaaaaaaaaaaaaaaaaaaaaaaaaaaaaaaaaaaaaaaaaaaaaaaaaaaaaaaaaaaaaaaaaaaaaaaaaaaaaaaaaaaaaaaaaaaaaaaaaaaaaaaaaaaaaaaaa
NNNNNNaaNNNNNaaaaaaaaaaaaaaaaaaaaaaaaaaaaaaaaaaaaaaaaaaaaaaaaaaaaaaaaaaaaaaaaaaaaaaaaaaaaaaaaaaaaaaaaaaaaaaaaaaaaaaaaaaaaaaaaaaaaa
NNNiiiiiiiNNNNNNaaaaaaaaaaaaaaaaaaaaaaaaaaaaaaaaaaaaaaaaaaaaaaaaaaaaaaaaaaaaaaaaaaaaaaaaaaaaaaaaaaaaaaaaaaaaaaaaaaaaaaaaaaaaaaaaaa
NNiiiiiiiiiNNNaaaaaaaaaaaaaaaaaaaaaaaaaaaaaaaaaaaaaaaaaaaaaaaaaaaaaaaaaaaaaaaaaaaaaaaaaaaaaaaaaaaaaaaaaaaaaaaaaaaaaaaaaaaaaaaaaaaa
NNiiiiniiNNNaaaaaaaaaaaaaaaaaaaaaaaaaaaaaaaaaaaaaaaaaaaaaaaaaaaaaaaaaaaaaaaaaaaaaaaaaaaaaaaaaaaaaaaaaaaaaaaaaaaaaaaaaaaaaaaaaaaaaa
NiiiinniSNaaaaaaaaaaaaaaaaaaaaaaaaaaaaaaaaaaaaaaaaaaaaaaaaaaaaaaaaaaaaaaaaaaaaaaaaaaaaaaaaaaaaaaaaaaaaaaaaaaaaaaaaaaaaaaaaaaaaaaaa
NiiiinnnSNaaaaaaaaaaaaaaaaaaaaaaaaaaaaaaaaaaaaaaaaaaaaaaaaaaaaaaaaaaaaaaaaaaaaaaaaaaaaaaaaaaaaaaaaaaaaaaaaaaaaaaaaaaaaaaaaaaaaaaaa
NiiiinnSSNaaaaaaaaaaaaaaaaaaaaaaaaaaaaaaaaaaaaaaaaaaaaaaaaaaaaaaaaaaaaaaaaaaaaaaaaaaaaaaaaaaaaaaaaaaaaaaaaaaaaaaaaaaaaaaaaaaaaaaaa
NSSSnnSSSNaaaaaaaaaaaaaaaaaaaaaaaaaaaaaaaaaaaaaaaaaaaaaaaaaaaaaaaaaaaaaaaaaaaaaaaaaaaaaaaaaaaaaaaaaaaaaaaaaaaaaaaaaaaaaaaaaaaaaaaa
NtdSSnSSSNaaaaaaaaaaaaaaaaaaaaaaaaaaaaaaaaaaaaaaaaaaaaaaaaaaaaaaaaaaaaaaaaaaaaaaaaaaaaaaaaaaaaaaaaaaaaaaaaaaaaaaaaaaaaaaaaaaaaaaaa
NSASnnSSSNNNaaaaaaaaaaaaaaaaaaaaaaaaaaaaaaaaaaaaaaaaaaaaaaaaaaaaaaaaaaaaaaaaaaaaaaaaaaaaaaaaaaaaaaaaaaaaaaaaaaaaaaaaaaaaaaaaaaaaaa
NSSSnnSSSNNNaaaaaaaaaaaaaaaaaaaaaaaaaaaaaaaaaaaaaaaaaaaaaaaaaaaaaaaaaaaaaaaaaaaaaaaaaaaaaaaaaaaaaaaaaaaaaaaaaaaaaaaaaaaaaaaaaaaaaa
NSSSnnSSSNNNaaaaaaaaaaaaaaaaaaaaaaaaaaaaaaaaaaaaaaaaaaaaaaaaaaaaaaaaaaaaaaaaaaaaaaaaaaaaaaaaaaaaaaaaaaaaaaaaaaaaaaaaaaaaaaaaaaaaaa
NSSSSSSSSSNaaaaaaaaaaaaaaaaaaaaaaaaaaaaaaaaaaaaaaaaaaaaaaaaaaaaaaaaaaaaaaaaaaaaaaaaaaaaaaaaaaaaaaaaaaaaaaaaaaaaaaaaaaaaaaaaaaaaaaa
NSSSSSSSSSNaaaaaaaaaaaaaaaaaaaaaaaaaaaaaaaaaaaaaaaaaaaaaaaaaaNNNaaaaaaaaaaaaaaaaaaaaaaaaaaaaaaaaaaaaaaaaaaaaaaaaaaaaaaaaaaaaaaaaaa
NNSSSSSSOSNNNaaaaaaaaaNNNNaaaaaNNaaaaaaaaaaaaaaaaaaaaaaNNNNNNNaNaaaaaaaaaaaaaaaaaaaaaaaaaaaaaaaaaaaaaaaaaaaaaaaaaaaaaaaaaaaaaaaaaa
NNSSSSSOOONNNNNNNNNNaaNNNNNNNaNNNaaaaaaNNNNNNaNNNNNNNNNNNNNNNNNNNNNNNNNNNNNNNNNNNNNNNNNNNNNNNNNNNNNNNNNNNNNNNNNNNNNNNNNNNNNNNNNNNN
NNSCCSOOOONNNNNNNNNNNNNNNNNNNNNNNNNNNNNNNNNNNNNNNNNNNNNNNNNNNNNNNNNNNNNNNNNNNNNNNNNNNNNNNNNNNNNNNNNNNNNNNNNNNNNNNNNNNNNNNNNNNNNNNN
"}
